wwwwwwwwwwwwT
w.....3.....w
w.3.........w
w.......b...w
www.w2..wwwww
w...b...b.tww
w..b........w
wA.......b..w
wwwwwwwwwwwww