Twwwwwwww
w...ww..w
w...wt..w
w...w..bw
w..bwb..w
w.......w
w3......w
w...2...w
w...wb..w
w.....b.w
w.3.w...w
w...w..Aw
wwwwwwwww