wwwwwwwww
wA..w...w
w...w.3.w
w.b.....w
w..bw...w
w...2...w
w......3w
w.......w
w..bwb..w
wb..w...w
w..tw...w
w..ww...w
wwwwwwwwT