Twwwwwwwwwwww
w.....3.....w
w.........3.w
w...b.......w
wwwww..2w.www
wwt.b...b...w
w........b..w
w..b.......Aw
wwwwwwwwwwwww