wwwwwwwwwwwww
w..b.......Aw
w........b..w
wwt.b...b...w
wwwww..2w.www
w...b.......w
w.........3.w
w.....3.....w
Twwwwwwwwwwww