wwwwwwwww
w...w..Aw
w.3.w...w
w.....b.w
w...wb..w
w...2...w
w3......w
w.......w
w..bwb..w
w...w..bw
w...wt..w
w...ww..w
Twwwwwwww