wwwwwwwwT
w..ww...w
w..tw...w
wb..w...w
w..bwb..w
w.......w
w......3w
w...2...w
w..bw...w
w.b.....w
w...w.3.w
wA..w...w
wwwwwwwww