wwwwwwwwwwwww
wA....ww.3..w
w......w....w
wwwwwb....b.w
w1.....t..b.w
wwwwwwww..b.w
w...w.......w
w.w....w2...w
Twwwwwwwwwwww