Twwwwwwww
w..w1w.Aw
ww.w.w..w
w..w.w..w
w.ww.w..w
w..w.b..w
w..w...ww
ww.wt.www
w2......w
w......3w
w..bbb..w
w.......w
wwwwwwwww