wwwwwwwww
w.......w
w..bbb..w
w3......w
w......2w
www.tw.ww
ww...w..w
w..b.w..w
w..w.ww.w
w..w.w..w
w..w.w.ww
wA.w1w..w
wwwwwwwwT