wwwwwwwwT
wA.w1w..w
w..w.w.ww
w..w.w..w
w..w.ww.w
w..b.w..w
ww...w..w
www.tw.ww
w......2w
w3......w
w..bbb..w
w.......w
wwwwwwwww