Twwwwwwwwwwww
w.w....w2...w
w...w.......w
wwwwwwww..b.w
w1.....t..b.w
wwwwwb....b.w
w......w....w
wA....ww.3..w
wwwwwwwwwwwww