wwwwwwwwwwwwT
w...2w....w.w
w.......w...w
w.b..wwwwwwww
w.b..t.....1w
w.b....bwwwww
w....w......w
w..3.ww....Aw
wwwwwwwwwwwww