wwwwwwwww
w.......w
w..bbb..w
w......3w
w2......w
ww.wt.www
w..w...ww
w..w.b..w
w.ww.w..w
w..w.w..w
ww.w.w..w
w..w1w.Aw
Twwwwwwww