wwwwwwwwwwwww
w...xwb-o.c-w
w....w--o.--w
w....w..o.--w
woo..w......w
w.ox.w......w
wxox.wc....ew
wxox.wo..x..w
w.o..w......w
woo..w....x.w
w...........w
w......A....w
w......o.wo.w
w........wo.w
w........wx.w
w........wx.w
wo.......xo.w
w..oo..o---bw
w.o.xo...x.-w
wx.oo......-w
wo.x.....o.-w
wxoo.....o.-w
wx.o.wwwwww-w
w...oxxx....w
w..ooxxx....w
wwwwwwwwwwwww