wwwwwwwwwwwww
w..ooxxx....w
w...oxxx....w
wx.o.wwwwww-w
wxoo.....o.-w
wo.x.....o.-w
wx.oo......-w
w.o.xo...x.-w
w..oo..o---bw
wo.......xo.w
w........wx.w
w........wx.w
w........wo.w
w......o.wo.w
w......A....w
w...........w
woo..w....x.w
w.o..w......w
wxox.wo..x..w
wxox.wc....ew
w.ox.w......w
woo..w......w
w....w..o.--w
w....w--o.--w
w...xwb-o.c-w
wwwwwwwwwwwww