wwwwwwwwwwwww
w....xxxoo..w
w....xxxo...w
w-wwwwww.o.xw
w-.o.....ooxw
w-.o.....x.ow
w-......oo.xw
w-.x...ox.o.w
wb---o..oo..w
w.ox.......ow
w.xw........w
w.xw........w
w.ow........w
w.ow.o......w
w....A......w
w...........w
w.x....w..oow
w......w..o.w
w..x..ow.xoxw
we....cw.xoxw
w......w.xo.w
w......w..oow
w--.o..w....w
w--.o--w....w
w-c.o-bwx...w
wwwwwwwwwwwww