wwwwwwwwwwwww
w-c.o-bwx...w
w--.o--w....w
w--.o..w....w
w......w..oow
w......w.xo.w
we....cw.xoxw
w..x..ow.xoxw
w......w..o.w
w.x....w..oow
w...........w
w....A......w
w.ow.o......w
w.ow........w
w.xw........w
w.xw........w
w.ox.......ow
wb---o..oo..w
w-.x...ox.o.w
w-......oo.xw
w-.o.....x.ow
w-.o.....ooxw
w-wwwwww.o.xw
w....xxxo...w
w....xxxoo..w
wwwwwwwwwwwww