wwwwwwwwwwwww
w...........w
w......-....w
w..A..x-.o--w
wxo...xb.x--w
wxo....-.x-cw
w...x..-.o--w
w...xo......w
w...x.......w
wxo....xo...w
wxo....xo...w
w......xo...w
w......xo..ow
w...........w
w..xo.......w
w.---.......w
w.-b-.....e.w
w.---.......w
w.......-...w
w.......-..ow
w.......c.xow
wx..o.xo-..ow
wx.o..xo...xw
w....xo....ow
w....xo...xow
wwwwwwwwwwwww