wwwwwwwwwwwww
w...........w
w....-......w
w--o.-x..A..w
w--x.bx...oxw
wc-x.-....oxw
w--o.-..x...w
w......ox...w
w.......x...w
w...ox....oxw
w...ox....oxw
w...ox......w
wo..ox......w
w...........w
w.......ox..w
w.......---.w
w.e.....-b-.w
w.......---.w
w...-.......w
wo..-.......w
wox.c.......w
wo..-ox.o..xw
wx...ox..o.xw
wo....ox....w
wox...ox....w
wwwwwwwwwwwww