wwwwwwwwwwwww
wox...ox....w
wo....ox....w
wx...ox..o.xw
wo..-ox.o..xw
wox.c.......w
wo..-.......w
w...-.......w
w.......---.w
w.e.....-b-.w
w.......---.w
w.......ox..w
w...........w
wo..ox......w
w...ox......w
w...ox....oxw
w...ox....oxw
w.......x...w
w......ox...w
w--o.-..x...w
wc-x.-....oxw
w--x.bx...oxw
w--o.-x..A..w
w....-......w
w...........w
wwwwwwwwwwwww