wwwwwwwwwwwww
w....xo...xow
w....xo....ow
wx.o..xo...xw
wx..o.xo-..ow
w.......c.xow
w.......-..ow
w.......-...w
w.---.......w
w.-b-.....e.w
w.---.......w
w..xo.......w
w...........w
w......xo..ow
w......xo...w
wxo....xo...w
wxo....xo...w
w...x.......w
w...xo......w
w...x..-.o--w
wxo....-.x-cw
wxo...xb.x--w
w..A..x-.o--w
w......-....w
w...........w
wwwwwwwwwwwww