wwwwwwwwwwwwwwwwwwwwwwwwww
w...A......o..ooo.....oo.w
www...oo...-..x...wow..x.w
woo...xx...-......wxw..x.w
wxx.wwwwww.-...-b-w.w..x.w
wxx........-.oo...w.w..x.w
w...wwo....-.xx.xx.......w
w.....x....-....www..ooo.w
w..-c-x...ww.....b-..xxx.w
w.....x...xx.....--...w..w
w...........oowww.....w..w
w....e...c..xx.....xx....w
wwwwwwwwwwwwwwwwwwwwwwwwww