wwwwwwwwwwwwwwwwwwwwwwwwww
w....xx.....xx..c...e....w
w..w.....wwwoo...........w
w..w...--.....xx...x.....w
w.xxx..-b.....ww...x-c-..w
w.ooo..www....-....x.....w
w.......xx.xx.-....oww...w
w.x..w.w...oo.-........xxw
w.x..w.w-b-...-.wwwwww.xxw
w.x..wxw......-...xx...oow
w.x..wow...x..-...oo...www
w.oo.....ooo..o......A...w
wwwwwwwwwwwwwwwwwwwwwwwwww