wwwwwwwwwwwww
w......xxow.w
w......xxow.w
w...-.......w
w...c.w.w..Aw
we..-.w.w...w
w..xxxo.wxo.w
w.......wxo.w
w.......w...w
wc......w...w
w..xw.......w
w..xw------ow
wxo.........w
wxo...xo....w
w.w...xo..xow
w.w.....-..ow
w.w..wx.b..ow
w..-bwx.-...w
w..--w.wwww.w
wx.......xo.w
wx.....wwww.w
w...xo......w
w.wwxo.....ow
w...xo.xxxxow
w...........w
wwwwwwwwwwwww