wwwwwwwwwwwww
w.woxx......w
w.woxx......w
w.......-...w
wA..w.w.c...w
w...w.w.-..ew
w.oxw.oxxx..w
w.oxw.......w
w...w.......w
w...w......cw
w.......wx..w
wo------wx..w
w.........oxw
w....ox...oxw
wox..ox...w.w
wo..-.....w.w
wo..b.xw..w.w
w...-.xwb-..w
w.wwww.w--..w
w.ox.......xw
w.wwww.....xw
w......ox...w
wo.....oxww.w
woxxxx.ox...w
w...........w
wwwwwwwwwwwww