wwwwwwwwwwwww
w...........w
woxxxx.ox...w
wo.....oxww.w
w......ox...w
w.wwww.....xw
w.ox.......xw
w.wwww.w--..w
w...-.xwb-..w
wo..b.xw..w.w
wo..-.....w.w
wox..ox...w.w
w....ox...oxw
w.........oxw
wo------wx..w
w.......wx..w
w...w......cw
w...w.......w
w.oxw.......w
w.oxw.oxxx..w
w...w.w.-..ew
wA..w.w.c...w
w.......-...w
w.woxx......w
w.woxx......w
wwwwwwwwwwwww