wwwwwwwwwwwwwwwwwwwwwwwwww
w....e...c..xx.....xx....w
w...........oowww.....w..w
w.....x...xx.....--...w..w
w..-c-x...ww.....b-..xxx.w
w.....x....-....www..ooo.w
w...wwo....-.xx.xx.......w
wxx........-.oo...w.w..x.w
wxx.wwwwww.-...-b-w.w..x.w
woo...xx...-......wxw..x.w
www...oo...-..x...wow..x.w
w...A......o..ooo.....oo.w
wwwwwwwwwwwwwwwwwwwwwwwwww