wwwwwwwwwwwww
w...........w
w...xo.xxxxow
w.wwxo.....ow
w...xo......w
wx.....wwww.w
wx.......xo.w
w..--w.wwww.w
w..-bwx.-...w
w.w..wx.b..ow
w.w.....-..ow
w.w...xo..xow
wxo...xo....w
wxo.........w
w..xw------ow
w..xw.......w
wc......w...w
w.......w...w
w.......wxo.w
w..xxxo.wxo.w
we..-.w.w...w
w...c.w.w..Aw
w...-.......w
w......xxow.w
w......xxow.w
wwwwwwwwwwwww