wwwwwwwwwwwww
w..ooxxx....w
w...oxxx....w
w.-o.wwwwwxww
wo-o.....ox.w
w.-x.....oo.w
w.-oo.....x.w
wo-.xo...x..w
w.boo..o--.-w
w........xoow
w........w.xw
w........w.xw
w.....o..w.ow
w..o...o.w.ow
w...o..Ao...w
w...........w
w...ow....oxw
w....w......w
w..x.wo..xx.w
w.ex.wc...x.w
w..x.w......w
w....w....o.w
w.-..w..o..-w
w.-..w--o..-w
w.-.xwb-o..cw
wwwwwwwwwwwww