wwwwwwwwwwwww
w....xxxoo..w
w....xxxo...w
wwxwwwww.o-.w
w.xo.....o-ow
w.oo.....x-.w
w.x.....oo-.w
w..x...ox.-ow
w-.--o..oob.w
woox........w
wx.w........w
wx.w........w
wo.w..o.....w
wo.w.o...o..w
w...oA..o...w
w...........w
wxo....wo...w
w......w....w
w.xx..ow.x..w
w.x...cw.xe.w
w......w.x..w
w.o....w....w
w-..o..w..-.w
w-..o--w..-.w
wc..o-bwx.-.w
wwwwwwwwwwwww