wwwwwwwwwwwww
w.-.xwb-o..cw
w.-..w--o..-w
w.-..w..o..-w
w....w....o.w
w..x.w......w
w.ex.wc...x.w
w..x.wo..xx.w
w....w......w
w...ow....oxw
w...........w
w...o..Ao...w
w..o...o.w.ow
w.....o..w.ow
w........w.xw
w........w.xw
w........xoow
w.boo..o--.-w
wo-.xo...x..w
w.-oo.....x.w
w.-x.....oo.w
wo-o.....ox.w
w.-o.wwwwwxww
w...oxxx....w
w..ooxxx....w
wwwwwwwwwwwww