wwwwwwwwwwwww
wc..o-bwx.-.w
w-..o--w..-.w
w-..o..w..-.w
w.o....w....w
w......w.x..w
w.x...cw.xe.w
w.xx..ow.x..w
w......w....w
wxo....wo...w
w...........w
w...oA..o...w
wo.w.o...o..w
wo.w..o.....w
wx.w........w
wx.w........w
woox........w
w-.--o..oob.w
w..x...ox.-ow
w.x.....oo-.w
w.oo.....x-.w
w.xo.....o-ow
wwxwwwww.o-.w
w....xxxo...w
w....xxxoo..w
wwwwwwwwwwwww