wwwwwwwwwwwww
w.-.c.-b.o.xw
w.-.-.--.o..w
w.-.-....o..w
w....o......w
wx..........w
wxe..x.c....w
wx...xxox...w
w...........w
w..xxo.....ow
w........o..w
w..........ow
wo..o.A.w...w
w...o.oow...w
w...x...w...w
w...x...w...w
w...oo..x...w
wob.-...--.ow
w.-o..o.x..xw
wo-..x.....ow
wx-..o..o...w
wo-o.x..o...w
wo-.wxwwww..w
w.....oo...ow
wo....xx...ow
wwwwwwwwwwwww