wwwwwwwwwwwww
wo...xx....ow
wo...oo.....w
w..wwwwxw.-ow
w...o..x.o-ow
w...o..o..-xw
wo.....x..-ow
wx..x.o..o-.w
wo.--...-.bow
w...x..oo...w
w...w...x...w
w...w...x...w
w...woo.o...w
w...w.A.o..ow
wo..........w
w..o........w
wo.....oxx..w
w...........w
w...xoxx...xw
w....c.x..exw
w..........xw
w......o....w
w..o....-.-.w
w..o.--.-.-.w
wx.o.b-.c.-.w
wwwwwwwwwwwww