wwwwwwwwwwwww
wx.o.b-.c.-.w
w..o.--.-.-.w
w..o....-.-.w
w......o....w
w..........xw
w....c.x..exw
w...xoxx...xw
w...........w
wo.....oxx..w
w..o........w
wo..........w
w...w.A.o..ow
w...woo.o...w
w...w...x...w
w...w...x...w
w...x..oo...w
wo.--...-.bow
wx..x.o..o-.w
wo.....x..-ow
w...o..o..-xw
w...o..x.o-ow
w..wwwwxw.-ow
wo...oo.....w
wo...xx....ow
wwwwwwwwwwwww