wwwwwwwwwwwww
wo....xx...ow
w.....oo...ow
wo-.wxwwww..w
wo-o.x..o...w
wx-..o..o...w
wo-..x.....ow
w.-o..o.x..xw
wob.-...--.ow
w...oo..x...w
w...x...w...w
w...x...w...w
w...o.oow...w
wo..o.A.w...w
w..........ow
w........o..w
w..xxo.....ow
w...........w
wx...xxox...w
wxe..x.c....w
wx..........w
w....o......w
w.-.-....o..w
w.-.-.--.o..w
w.-.c.-b.o.xw
wwwwwwwwwwwww