wwwwwwwwwww
wA.101.1m0w
w.1101.100w
w.1001.100w
w.1011.100w
w.101..100w
w1101..100w
w0001.1100w
w0001.1000w
w0001.1001w
w1111.1000w
wg....110kw
wwwwwwwwwww