wwwwwwwwwwwww
wk0100000000w
w0000000000mw
w10001111111w
w11111......w
w.......1111w
w.1111111000w
w.1000000011w
w.100011111.w
wg10001....Aw
wwwwwwwwwwwww