wwwwwwwwwww
w0m1.101.Aw
w001.1011.w
w001.1001.w
w001.1101.w
w001..101.w
w001..1011w
w0011.1000w
w0001.1000w
w1001.1000w
w0001.1111w
wk011....gw
wwwwwwwwwww