wwwwwwwwwww
wk011....gw
w0001.1111w
w1001.1000w
w0001.1000w
w0011.1000w
w001..1011w
w001..101.w
w001.1101.w
w001.1001.w
w001.1011.w
w0m1.101.Aw
wwwwwwwwwww