wwwwwwwwwww
wg....110kw
w1111.1000w
w0001.1001w
w0001.1000w
w0001.1100w
w1101..100w
w.101..100w
w.1011.100w
w.1001.100w
w.1101.100w
wA.101.1m0w
wwwwwwwwwww