wwwwwwwwwwwww
wg10001....Aw
w.100011111.w
w.1000000011w
w.1111111000w
w.......1111w
w11111......w
w10001111111w
w0000000000mw
wk0100000000w
wwwwwwwwwwwww