wwwwwwwwwwwww
w0000000010kw
wm0000000000w
w11111110001w
w......11111w
w1111.......w
w0001111111.w
w1100000001.w
w.111110001.w
wA....10001gw
wwwwwwwwwwwww