wwwwwww
w.gwwww
w.1.10w
w.1A1.w
w.1110w
w.10m0w
w..000w
wwwwwkw
wwwwwww