wwwwwww
wwwwg.w
w01.1.w
w.1A1.w
w0111.w
w0m01.w
w000..w
wkwwwww
wwwwwww