wwwwwww
wwwwwkw
w..000w
w.10m0w
w.1110w
w.1A1.w
w.1.10w
w.gwwww
wwwwwww