wwwwwwwww
w...ww..w
w..gw+..w
w...w..ww
w..www..w
w.......w
w2......w
w...2...w
w...ww..w
w.....w.w
w.2.w...w
w...w..Aw
wwwwwwwww