wwwwwwwww
w..ww...w
w..+wg..w
ww..w...w
w..www..w
w.......w
w......2w
w...2...w
w..ww...w
w.w.....w
w...w.2.w
wA..w...w
wwwwwwwww