wwwwwwwwwwwww
w..w.......Aw
w........w..w
ww+.w...w...w
wwwww..2w.www
w.g.w.......w
w.........2.w
w.....2.....w
wwwwwwwwwwwww