wwwwwwwwwwwww
w.....2.....w
w.2.........w
w.......w.g.w
www.w2..wwwww
w...w...w.+ww
w..w........w
wA.......w..w
wwwwwwwwwwwww