wwwwwwwwwwwww
w.....2.....w
w.........2.w
w.g.w.......w
wwwww..2w.www
ww+.w...w...w
w........w..w
w..w.......Aw
wwwwwwwwwwwww