wwwwwwwww
wA..w...w
w...w.2.w
w.w.....w
w..ww...w
w...2...w
w......2w
w.......w
w..www..w
ww..w...w
w..+wg..w
w..ww...w
wwwwwwwww