wwwwwwwww
w...w..Aw
w.2.w...w
w.....w.w
w...ww..w
w...2...w
w2......w
w.......w
w..www..w
w...w..ww
w..gw+..w
w...ww..w
wwwwwwwww