wwwwwwwwwwwww
w.1....wg.3.w
w......www..w
w2..........w
wwwww.......w
w..+w.......w
w...w...w...w
w.......w..Aw
wwwwwwwwwwwww