wwwwwwwww
wA......w
w......3w
w.....w.w
www...wgw
w.....www
w.......w
w.......w
w.www...w
w..+w...w
w...w..1w
w...w2..w
wwwwwwwww