wwwwwwwww
w..2w...w
w1..w...w
w...w+..w
w...www.w
w.......w
w.......w
www.....w
wgw...www
w.w.....w
w3......w
w......Aw
wwwwwwwww