wwwwwwwwwwwww
w.......w..Aw
w...w...w...w
w..+w.......w
wwwww.......w
w2..........w
w......www..w
w.1....wg.3.w
wwwwwwwwwwwww