wwwwwwwww
w......Aw
w3......w
w.w.....w
wgw...www
www.....w
w.......w
w.......w
w...www.w
w...w+..w
w1..w...w
w..2w...w
wwwwwwwww