wwwwwwwwwwwww
wA..w.......w
w...w...w...w
w.......w+..w
w.......wwwww
w..........2w
w..www......w
w.3.gw....1.w
wwwwwwwwwwwww