wwwwwwwww
w...w2..w
w...w..1w
w..+w...w
w.www...w
w.......w
w.......w
w.....www
www...wgw
w.....w.w
w......3w
wA......w
wwwwwwwww