wwwwwwwwwwwww
wA....ww.3..w
w......w....w
wwwww.....w.w
w1........w+w
wwwwwwww..w.w
w...w.......w
wgw....w2...w
wwwwwwwwwwwww