wwwwwwwww
wg.w1w.Aw
ww.w.w..w
w..w.w..w
w.ww.w..w
w..w....w
w..w...ww
ww.w..www
w2......w
w......3w
w..www..w
w...+...w
wwwwwwwww