wwwwwwwww
w...+...w
w..www..w
w3......w
w......2w
www..w.ww
ww...w..w
w....w..w
w..w.ww.w
w..w.w..w
w..w.w.ww
wA.w1w.gw
wwwwwwwww