wwwwwwwww
w...+...w
w..www..w
w......3w
w2......w
ww.w..www
w..w...ww
w..w....w
w.ww.w..w
w..w.w..w
ww.w.w..w
wg.w1w.Aw
wwwwwwwww