wwwwwwwwwwwww
w...2w....wgw
w.......w...w
w.w..wwwwwwww
w+w........1w
w.w.....wwwww
w....w......w
w..3.ww....Aw
wwwwwwwwwwwww