wwwwwwwwwwwww
wgw....w2...w
w...w.......w
wwwwwwww..w.w
w1........w+w
wwwww.....w.w
w......w....w
wA....ww.3..w
wwwwwwwwwwwww