wwwwwwwww
wA.w1w.gw
w..w.w.ww
w..w.w..w
w..w.ww.w
w....w..w
ww...w..w
www..w.ww
w......2w
w3......w
w..www..w
w...+...w
wwwwwwwww