wwwwwwwww
w......gw
w.w.....w
w.......w
w.w3....w
w....1..w
w.w.....w
w..2..w.w
wA...w..w
w.w.....w
w..1ww..w
w..w+...w
wwwwwwwww