wwwwwwwww
w...+w..w
w..ww1..w
w.....w.w
w..w...Aw
w.w..2..w
w.....w.w
w..1....w
w....3w.w
w.......w
w.....w.w
wg......w
wwwwwwwww