wwwwwwwww
w..w+...w
w..1ww..w
w.w.....w
wA...w..w
w..2..w.w
w.w.....w
w....1..w
w.w3....w
w.......w
w.w.....w
w......gw
wwwwwwwww