wwwwwwwww
wg......w
w.....w.w
w.......w
w....3w.w
w..1....w
w.....w.w
w.w..2..w
w..w...Aw
w.....w.w
w..ww1..w
w...+w..w
wwwwwwwww