wwwwwwwwwwwww
w.1...+w...Aw
w..2...w....w
w....w......w
w..wwwwwww..w
w....www..2.w
w.....www...w
w.g....w....w
wwwwwwwwwwwww