wwwwwwwwwwwww
wA...w+...1.w
w....w...2..w
w......w....w
w..wwwwwww..w
w.2..www....w
w...www.....w
w....w....g.w
wwwwwwwwwwwww