wwwwwwwwwwwww
w.g....w....w
w.....www...w
w....www..2.w
w..wwwwwww..w
w....w......w
w..2...w....w
w.1...+w...Aw
wwwwwwwwwwwww