wwwwwwwww
w......Aw
w..2....w
w...w...w
w.w.w...w
wwwww.www
w.www..+w
w..www..w
w...w...w
w...w.2.w
wg.....1w
w.......w
wwwwwwwww