wwwwwwwww
w.......w
w1.....gw
w.2.w...w
w...w...w
w..www..w
w+..www.w
www.wwwww
w...w.w.w
w...w...w
w....2..w
wA......w
wwwwwwwww