wwwwwwwww
w.......w
wg.....1w
w...w.2.w
w...w...w
w..www..w
w.www..+w
wwwww.www
w.w.w...w
w...w...w
w..2....w
w......Aw
wwwwwwwww