wwwwwwwww
wA......w
w....2..w
w...w...w
w...w.w.w
www.wwwww
w+..www.w
w..www..w
w...w...w
w.2.w...w
w1.....gw
w.......w
wwwwwwwww