wwwwwwwwwwwwwwwwwwwwwwwwwww
w........................Aw
w.........................w
w.........................w
w..c......................w
w.........................w
w..................k......w
w.........................w
w.........................w
w................2........w
w.f.....2...........3.....w
w....................3....w
wdddddddddddddddddddddddddw
wgggggggggggggggggggggggggw
wwwwwwwwwwwwwwwwwwwwwwwwwww