wwwwwwwwwwwwwww
wA..........dgw
w...........dgw
w...........dgw
w...........dgw
w..........3dgw
w.........3.dgw
w.....k.....dgw
w...........dgw
w........2..dgw
w...........dgw
w...........dgw
w...........dgw
w...........dgw
w...........dgw
w...........dgw
w...........dgw
w...........dgw
w.........2.dgw
w...........dgw
w...........dgw
w...........dgw
w...........dgw
w...c.......dgw
w.........f.dgw
w...........dgw
wwwwwwwwwwwwwww