wwwwwwwwwwwwwww
wgd..........Aw
wgd...........w
wgd...........w
wgd...........w
wgd3..........w
wgd.3.........w
wgd.....k.....w
wgd...........w
wgd..2........w
wgd...........w
wgd...........w
wgd...........w
wgd...........w
wgd...........w
wgd...........w
wgd...........w
wgd...........w
wgd.2.........w
wgd...........w
wgd...........w
wgd...........w
wgd...........w
wgd.......c...w
wgd.f.........w
wgd...........w
wwwwwwwwwwwwwww