wwwwwwwwwwwwwww
w...........dgw
w.........f.dgw
w...c.......dgw
w...........dgw
w...........dgw
w...........dgw
w...........dgw
w.........2.dgw
w...........dgw
w...........dgw
w...........dgw
w...........dgw
w...........dgw
w...........dgw
w...........dgw
w...........dgw
w........2..dgw
w...........dgw
w.....k.....dgw
w.........3.dgw
w..........3dgw
w...........dgw
w...........dgw
w...........dgw
wA..........dgw
wwwwwwwwwwwwwww