wwwwwwwwwwwwwwwwwwwwwwwwwww
wgggggggggggggggggggggggggw
wdddddddddddddddddddddddddw
w....................3....w
w.f.....2...........3.....w
w................2........w
w.........................w
w.........................w
w..................k......w
w.........................w
w..c......................w
w.........................w
w.........................w
w........................Aw
wwwwwwwwwwwwwwwwwwwwwwwwwww