wwwwwwwwwwwwwww
wgd...........w
wgd.f.........w
wgd.......c...w
wgd...........w
wgd...........w
wgd...........w
wgd...........w
wgd.2.........w
wgd...........w
wgd...........w
wgd...........w
wgd...........w
wgd...........w
wgd...........w
wgd...........w
wgd...........w
wgd..2........w
wgd...........w
wgd.....k.....w
wgd.3.........w
wgd3..........w
wgd...........w
wgd...........w
wgd...........w
wgd..........Aw
wwwwwwwwwwwwwww