wwwwwwwwwwwwwwwwwwwwwwwwwww
wA........................w
w.........................w
w.........................w
w......................c..w
w.........................w
w......k..................w
w.........................w
w.........................w
w........2................w
w.....3...........2.....f.w
w....3....................w
wdddddddddddddddddddddddddw
wgggggggggggggggggggggggggw
wwwwwwwwwwwwwwwwwwwwwwwwwww