wwwwwwwwwwwwww
w.w....w..twxw
w.ww.w.w.www.w
w.ww.w.w.w.w.w
w.ww.....w.w.w
w....w.www...w
w.ww.w.ww..www
wtww.w.www.www
w.ww.w.www.www
w........w...w
w.ww.www.www.w
w.ww.w.w...w.w
w..w.w.w.www.w
wwww.w.w.....w
wA...w...wwwww
wwwwwwwwwwwwww