wwwwwwwwwwwwww
wwwww...w...Aw
w.....w.w.wwww
w.www.w.w.w..w
w.w...w.w.ww.w
w.www.www.ww.w
w...w........w
www.www.w.ww.w
www.www.w.wwtw
www..ww.w.ww.w
w...www.w....w
w.w.w.....ww.w
w.w.w.w.w.ww.w
w.www.w.w.ww.w
wxwt..w....w.w
wwwwwwwwwwwwww