wwwwwwwwwwwwww
wxwt..w....w.w
w.www.w.w.ww.w
w.w.w.w.w.ww.w
w.w.w.....ww.w
w...www.w....w
www..ww.w.ww.w
www.www.w.wwtw
www.www.w.ww.w
w...w........w
w.www.www.ww.w
w.w...w.w.ww.w
w.www.w.w.w..w
w.....w.w.wwww
wwwww...w...Aw
wwwwwwwwwwwwww