wwwwwwwwwwwwww
wA...w...wwwww
wwww.w.w.....w
w..w.w.w.www.w
w.ww.w.w...w.w
w.ww.www.www.w
w........w...w
w.ww.w.www.www
wtww.w.www.www
w.ww.w.ww..www
w....w.www...w
w.ww.....w.w.w
w.ww.w.w.w.w.w
w.ww.w.w.www.w
w.w....w..twxw
wwwwwwwwwwwwww