wwwwwwwwwwwwww
wA...........w
wtwwwwwwwwww.w
w............w
w.wwwwwwww.www
w.w...ww.w.w.w
w.w.t.w..w.w.w
w.w.w.w.ww.w.w
w.w.w.w..w.w.w
w.w.w.ww.w.w.w
w.w.w.w..w.w.w
w.w.w.w.ww.t.w
w.w.w.w......w
w.w.w.wwwwwwww
w...w.......xw
wwwwwwwwwwwwww