wwwwwwwwwwwwww
w...........Aw
w.wwwwwwwwwwtw
w............w
www.wwwwwwww.w
w.w.w.ww...w.w
w.w.w..w.t.w.w
w.w.ww.w.w.w.w
w.w.w..w.w.w.w
w.w.w.ww.w.w.w
w.w.w..w.w.w.w
w.t.ww.w.w.w.w
w......w.w.w.w
wwwwwwww.w.w.w
wx.......w...w
wwwwwwwwwwwwww