wwwwwwwwwwwww
w..........ww
w.1........ww
w.......w.0.w
www.w1..wwwww
w...A.1.w.0ww
w...1.......w
w........w..w
wwwwwwwwwwwww