wwwwwwwww
w...w...w
w...w.1.w
w.......w
w.1Aw...w
w...1...w
w..1....w
w.......w
w..www..w
ww..w...w
w..0w0..w
w..ww.www
wwwwwwwww