wwwwwwwww
www.ww..w
w..0w0..w
w...w..ww
w..www..w
w.......w
w....1..w
w...1...w
w...wA1.w
w.......w
w.1.w...w
w...w...w
wwwwwwwww