wwwwwwwww
w...w...w
w.1.w...w
w.......w
w...wA1.w
w...1...w
w....1..w
w.......w
w..www..w
w...w..ww
w..0w0..w
www.ww..w
wwwwwwwww