wwwwwwwww
w..ww.www
w..0w0..w
ww..w...w
w..www..w
w.......w
w..1....w
w...1...w
w.1Aw...w
w.......w
w...w.1.w
w...w...w
wwwwwwwww