wwwwwwwwwwwww
w..w........w
w.......1...w
ww0.w.1.A...w
wwwww..1w.www
w.0.w.......w
ww........1.w
ww..........w
wwwwwwwwwwwww