wwwwwwwwwwwww
ww..........w
ww........1.w
w.0.w.......w
wwwww..1w.www
ww0.w.1.A...w
w.......1...w
w..w........w
wwwwwwwwwwwww