wwwwwwwww
w.0w..www
w..w....w
w..w....w
w..1....w
w..w....w
w.......w
w....0..w
w.....1.w
w.01www.w
w...wwwAw
w...wwwww
wwwwwwwww