wwwwwwwww
wwwww...w
wAwww...w
w.www10.w
w.1.....w
w..0....w
w.......w
w....w..w
w....1..w
w....w..w
w....w..w
www..w0.w
wwwwwwwww