wwwwwwwww
w...wwwww
w...wwwAw
w.01www.w
w.....1.w
w....0..w
w.......w
w..w....w
w..1....w
w..w....w
w..w....w
w.0w..www
wwwwwwwww