wwwwwwwww
www..w0.w
w....w..w
w....w..w
w....1..w
w....w..w
w.......w
w..0....w
w.1.....w
w.www10.w
wAwww...w
wwwww...w
wwwwwwwww