wwwwwwwww
wwwww...w
w...w.w.w
w...w.0.w
www.w11ww
w...0...w
w.....w.w
www...w.w
w.......w
w0A...1.w
wwwwwwwww