wwwwwwwwwww
ww..w..w.0w
ww..w..w.Aw
ww........w
wwwww0....w
w...1.....w
w.w01.ww.1w
w...w.....w
wwwwwwwwwww