wwwwwwwww
w.1...A0w
w.......w
w.w...www
w.w.....w
w...0...w
ww11w.www
w.0.w...w
w.w.w...w
w...wwwww
wwwwwwwww