wwwwwwwww
w...wwwww
w.w.w...w
w.0.w...w
ww11w.www
w...0...w
w.w.....w
w.w...www
w.......w
w.1...A0w
wwwwwwwww