wwwwwwwwwww
w.....w...w
w1.ww.10w.w
w.....1...w
w....0wwwww
w........ww
wA.w..w..ww
w0.w..w..ww
wwwwwwwwwww