wwwwwwwwwww
w0.w..w..ww
wA.w..w..ww
w........ww
w....0wwwww
w.....1...w
w1.ww.10w.w
w.....w...w
wwwwwwwwwww