wwwwwwwww
w0A...1.w
w.......w
www...w.w
w.....w.w
w...0...w
www.w11ww
w...w.0.w
w...w.w.w
wwwww...w
wwwwwwwww