wwwwwwww
w......w
w.A..w.w
w.1w...w
w...w..w
w0..1.0w
w...wwww
www.wwww
wwwwwwww