wwwwwwww
www.wwww
w...wwww
w0..1.0w
w...w..w
w.1w...w
w.A..w.w
w......w
wwwwwwww