wwwwwwww
w......w
w.w..A.w
w...w1.w
w..w...w
w0.1..0w
wwww...w
wwww.www
wwwwwwww