wwwwwwww
wwww.www
wwww...w
w0.1..0w
w..w...w
w...w1.w
w.w..A.w
w......w
wwwwwwww