wwwwwwwwwwwwww
wxwt..w....w.w
w.www.b.w.ww.w
w.w.w.b.w.ww2w
w.w.b.b...ww.w
w.w.www.w....w
wrw..ww.w.ww.w
wrw.www.w.wwtw
wrw.www.w.ww.w
w.w...w......w
w.www.www.ww.w
w.w...w1w.ww.w
w.www.w.w.w..w
w.rrr.w.w.wwww
wwwww...w...Aw
wwwwwwwwwwwwww