wwwwwwwwwwwwww
w.w....w..twxw
w.ww.w.b.www.w
w2ww.w.b.w.w.w
w.ww...b.b.w.w
w....w.www.w.w
w.ww.w.ww..wrw
wtww.w.www.wrw
w.ww.w.www.wrw
w......w...w.w
w.ww.www.www.w
w.ww.w1w...w.w
w..w.w.w.www.w
wwww.w.w.rrr.w
wA...w...wwwww
wwwwwwwwwwwwww