wwwwwwwwwwwwww
wA...w...wwwww
wwww.w.w.rrr.w
w..w.w.w.www.w
w.ww.w1w...w.w
w.ww.www.www.w
w......w...w.w
w.ww.w.www.wrw
wtww.w.www.wrw
w.ww.w.ww..wrw
w....w.www.w.w
w.ww...b.b.w.w
w2ww.w.b.w.w.w
w.ww.w.b.www.w
w.w....w..twxw
wwwwwwwwwwwwww