wwwwwwwwwwwwww
wwwww...w...Aw
w.rrr.w.w.wwww
w.www.w.w.w..w
w.w...w1w.ww.w
w.www.www.ww.w
w.w...w......w
wrw.www.w.ww.w
wrw.www.w.wwtw
wrw..ww.w.ww.w
w.w.www.w....w
w.w.b.b...ww.w
w.w.w.b.w.ww2w
w.www.b.w.ww.w
wxwt..w....w.w
wwwwwwwwwwwwww