wwwwwwwwwwwwww
w...w.......xw
w.wrw.wwwwwwww
w.wrw.w..r...w
w.wrw.w.ww.t.w
w.wrw.w..w.w.w
w.wrw.ww.w.w.w
w.wrw.w..w.w.w
w.w.w.w.ww.w.w
w.w.t.w..w.w.w
w.w...ww2w.w1w
w.wwwwwwww.www
w............w
wtwwwwwwwwww.w
wA...........w
wwwwwwwwwwwwww