wwwwwwwwwwwwww
w...........Aw
w.wwwwwwwwwwtw
w............w
www.wwwwwwww.w
w1w.w2ww...w.w
w.w.w..w.t.w.w
w.w.ww.w.w.w.w
w.w.w..w.wrw.w
w.w.w.ww.wrw.w
w.w.w..w.wrw.w
w.t.ww.w.wrw.w
w...r..w.wrw.w
wwwwwwww.wrw.w
wx.......w...w
wwwwwwwwwwwwww