wwwwwwwwwwwwww
wx.......w...w
wwwwwwww.wrw.w
w...r..w.wrw.w
w.t.ww.w.wrw.w
w.w.w..w.wrw.w
w.w.w.ww.wrw.w
w.w.w..w.wrw.w
w.w.ww.w.w.w.w
w.w.w..w.t.w.w
w1w.w2ww...w.w
www.wwwwwwww.w
w............w
w.wwwwwwwwwwtw
w...........Aw
wwwwwwwwwwwwww