wwwwwwwwwwwwww
wA...........w
wtwwwwwwwwww.w
w............w
w.wwwwwwww.www
w.w...ww2w.w1w
w.w.t.w..w.w.w
w.w.w.w.ww.w.w
w.wrw.w..w.w.w
w.wrw.ww.w.w.w
w.wrw.w..w.w.w
w.wrw.w.ww.t.w
w.wrw.w..r...w
w.wrw.wwwwwwww
w...w.......xw
wwwwwwwwwwwwww